50 100
###################################################################################################
#.................................................................................................#
#.................................................................................................#
#.............................................##########..........................................#
#.............................................#........#..........................................#
#.............................................#........#..........................................#
#.............................................#........#..........................................#
#.............................................#........#..........................................#
#.............................................#........#..........................................#
#.............................................#........#..........................................#
#.............................................#........#..........................................#
#.............................................#........#..........................................#
#.............................................#........#..........................................#
#.............................................#........#..........................................#
#.............................................#........#..........................................#
#.............................................#........#..........................................#
#.............................................#........#..........................................#
#.............................................#........#..........................................#
#.............................................#........#..........................................#
#.............................................##########..........................................#
#..............................................#..................................................#
#..............................................#..................................................#
#..............................................#..................................................#
#..............................................#..................................................#
#..............................................#..................................................#
#..............................................#..................................................#
#..............................................#..................................................#
#..............................................#..................................................#
#..............................................#..................................................#
#..............................................#..................................................#
#..............................................#..................................................#
#..............................................#..................................................#
#..............................................#..................................................#
#..............................................#..................................................#
#..............................................#..................................................#
#..............................................#..................................................#
#..............................................#..................................................#
#..............................................#..................................................#
#..............................................#..................................................#
#..............................................#..................................................#
#..............................................#..................................................#
#..............................................#..................................................#
#..............................................#..................................................#
#.................................................................................................#
#.................................................................................................#
#.................................................................................................#
#.................................................................................................#
#.................................................................................................#
#.................................................................................................#
###################################################################################################

